"","insert","Freq","integer"
"1","NA",82608,"0"
"2","CAT",19733,"1"
"3","CCG",19781,"2"
"4","GCC",19411,"3"
"5","ATA",13940,"4"
"6","GAT",12374,"5"
"7","ACG",10348,"6"
"8","ACA",6992,"7"
"9","TCG",5289,"8"
"10","TAT",5481,"9"
"11","GCT",4632,"10"
"12","CTA",3443,"11"
"13","TGT",2549,"12"
"14","AGA",847,"13"
"15","TAA",462,"14"
"16","CAG",480,"15"
"17","TAG",322,"16"
"18","GAG",329,"17"
"19","ACC",203,"18"
"20","GCG",141,"19"
