tape_names,tape_identifier
1,AACTGAATGTTT
2,AGGCTAATTCCC
3,GTACAAAATAGT
4,GTATAAAGTTTG
5,GTTGAAAGGTGA
6,TAACGAAGATTT
7,TTCACAAATTTA
8,TTGATAACGTGA
